zzzzzzzzzzzzzzzzzzzzz
zzzzzzzzzzzzzzzzzzzzz
111111111111111111111
13xxx0000000000003001
1x1x10101010101010101
1xxx00000000000000001
101010101010101010101
100000000000000000001
101010101010101x1x101
10000000000000xx3xx01
101010101010101x1x101
100000000000000000001
111111111111111111111
