zzzzzzzzzzzzzzzzzzzzz
zzzzzzzzzzzzzzzzzzzzz
111111111111111111111
13xxx0000000000000001
1x1010101010101010101
1x0000000000000000001
101010101010101010101
100000000000000000001
101010101010101010101
1xxx0000000000000xxx1
1x1x1010101010101x1x1
1xxx0000000000000xx31
111111111111111111111
