zzzzzzzzzzzzzzzzzzzzz
zzzzzzzzzzzzzzzzzzzzz
111111111111111111111
13xxx000000000000xxx1
1x101010101010101x1x1
1x000000000000000xxx1
101010101010101010101
100000000000000000001
1010101010101010101x1
1xxx0000000000000xxx1
1x1x1010101010101x1x1
1xxx0000000000000xx31
111111111111111111111
